EEEEWEEgEEWEWEEWE2E
EEEEWEEEEEWEWEEW433
EEEEWEEEEEWEREEWEE4
EWWWWEEEEEGEWEEWWYW
EEEEEEEEEEWEWEEEEEE
EEEEEEEEEEWEWWWWWWW
WWWWEEEEEEWEEEEEEEE
yyEWEEEEEEWWWWWWWWW
EEEWEEEEEEEEEEEEEEE
EEE*EEEEEEEEEEEEErE